CC                                                             CCCCCCCCCCCCC                                                                                                                       CCCCCCCCCCCCCCCCCCCCCCCCCCCCCCCCCCCC                                                                                                                                                                                        
 CC                CCCCC                                     CCC           CC                                                                                                                     C                                    C                                                                                                                                                                                       
  CCCCCC          CC   CC                               CCCCCC              CCCCCCCCCCCCC                                                                                                        C                                      C                                                                                                                                                                                      
       CCCC     CCC     CC               CCCC         CCC                               CC                                                                                                      C                                        CCCCCCCCCCC                                                                                                                                                                           
          CCCCCCC        C             CCC  CC      CCC                                  CCCCCCCCCCCCCCCCCCCC                                                                                  C                                                    CCCCCCCCCC                                                                                                                        CCCCCCCCCC                               
                         CCCCCCCCC    CC     CCCCCCCC                                                       CCCCCCCCCCCCCCCCCCCC                                           CCCCCCCCCCCCCCCCCCCC                                                               CCCCCCCCCC                                                                                                    CCCCCCCCCC          CCCCCCCCCC                     
                                 CCCCCC                                      X                                                 CC                                         C                                                                                             CCCCCCCCCC                                                                                CCCCCCCCCC                              C                    
                                                                                                                                CCCCC                                    C                                                                                                        CCCCCCCCCC                                                    C       CCCCCCCCCC                                         C                   
                                                                                                                                     C                                  C                                                                                                                   CCCCCCCCCC                                         C C     C                                                    C                 C
                                                                                                                                      C          CCCCCCCCCCCCCCCCCCCCCCC                                                                                                                              CCCCCCCCCC                              C   C   C                                                      C               C 
                                                                                                                                       C        C                                                                                                                                                               CCCCCCCCCC                   C     C C                                                        C             C  
                                                                                                                                        C      C                                                      X                                                                                                                   C                 C       C                                                          CCCCCCCCCCCCC   
                                             X                                                                                           CCC  C                                                                                     X                                                                                      C               C                                X                                                  
                                                                                                                                            C C                                                                                                                                                                             C             C                                                                                    
                                                                                                                                             C                                                                                                                                                                               C           C                                                                                     
                                                                                                                                                                                                                                                                                                                              CCCCCCCCCCC                                                                                      
                                                                                                                                                                                                                                                                                                                                                                                                                               
                                                                                                                                                                                                                                                                                                                                                                                                                               
               @                                                                                                                                                              X                                                                                                                              X                                                                                                                 
                                                                                                                                                                                                                                                                     X                                                                                                                                     X                   
                                                                                                                                                                                                                                                                                                                                                                                                                               
                                                                                                                  X                                                                                                                                                                                                                                                                                                            
                                                                                                                                                                                                                                                                                                                                                                                                                               
                                                                X                                                                                                                                                                                                                                                                                                X                                                             
                                                                                                                                                                                   C                              X                                                                                                                                                                                                            
                                                                                                                                                                                  C C                                                                    C                                                                                                                                                   C                C
                                                                                                                                                                                 C   C                                                                  C C                                                                                                              CCCCCCCCCCCCCCCCCCCC     C         C C              C 
                                                                                                                                                                                C     C                                                                C   CCC                                                             X              C                             C                    C   C C       C   C   CCCCCCCCCC  
                                                                                                 CCCCCCCCCCCCCCCCCCCCC                                         C               C       C                                                              C       CCCCCCCCCC                       CCCCCCCCCCC                               C C                           C                      C C   C     C     C C            
           CCCCCCC                                                                              C                     C                                       C C             C         CCCCCCCCCCC                                                  C                  CCCCCCCCCC            C          C                              C   C                         C                        C     C   C       C             
   CCCCCCCCC     C                                   C                                         C                       C                                     C   C           C                     C                                                C                             C          C            C                            C     CCCCCCCCCCC              C                               C C                      
CCCC             CC                                CC C                  CCCCCCCCCCCCCCCCCCCCCC                         C                         CCCCCCCCCCC     CCCCCCCCCCC                       CCCCCCCCCCC                                    C                               CCCCCCCCCCC             C                          C                 C             C                                C                       
                  CCC                             CC  CC                CC                                               C                       C                                                             C                     CCCCCCCCCC   C                                                         C                        C                   C            C                                                        
                    CC                           CC    CCCCCCCCCCCCCCCCCC                                                 C                     C                                                               C          CCCCCCCCCC          C C                                                           C                      C                     C           C                                                        
                     CCCCCCCCCCCCCCCCCCCCCCCCCCCCC                                                                         CCCCCCCCCCCCCCCCCCCCC                                                                 CCCCCCCCCC                     C                                                             CCCCCCCCCCCCCCCCCCCCCC                       CCCCCCCCCCC                                                         